############&###
#.#...####.....#
#.#.#....####.##
#...####.#.#...#
###.#......###.#
#...######.#.#.#
#.#......#...#.#
########.###...#
##.......#.#####
##.####.##.....#
##.#..#.#..###.#
#..#.##.#....#.#
#....#..####.#.#
####.##..#.#.###
#....#........@#
################
