...###.....
..##.#.#.##
.##..###..#
##........#
#...@..#..#
###..###..#
..#..#....#
.##.##.#.##
.#......##.
.#.....##..
.####.##...