###########
@####.....#
..##...##.#
#....####.#
#########.#
###.......#
#...#...###
..#####.###
#........##
#####.#####
#.#..#.#.#.