######..&..
#..#.#.####
#..&.#.#..#
##.....#..#
#......#..#
###....&..#
.....#.....
.##.....@##
.#&##.####.
.#.....##..
&#######&..