########.&#
&####.&...#
..##...##.#
#&...####&#
#########.#
###...@...#
#&..#...###
..#####.###
#&......&##
####..#####
#&#&.#.#.#&