###########
#&..#.....#
#.#.#@##..#
##&.#..#&##
#....##...#
#.#..&###.#
#&.##...#&#
##...#....#
###&.#.#.##
#...#..&.##
#&#########