#.&.###.###
###...#.&.#
.&###...#.#
#...#.#.#.&
#.#...#.#.#
#.#.#.#.#.#
#...#...#.#
@.#.#.##..&
#.#.#.###.#
#.#&#.#.#&#
#&..#.&..##