###########
#...#.....#
#.#.#@##..#
##..#..#.##
#....##...#
#.#...###.#
#..##...#.#
##...#....#
###..#.#.##
#...#....##
#.#########