#...###.###
###...#...#
..###...#.#
#...#.#.#..
#.#...#.#.#
#.#.#.#.#.#
#...#...#.#
@.#.#.##...
#.#.#.###.#
#.#.#.#.#.#
#...#....##