&..###...&.
..##.#.#.##
.##..###.&#
##........#
#...@..#.&#
###..###..#
&.#..#..&.#
.##.##&#.##
.#...&..##.
.#.....##.&
.####.##&..